111111111111111111111111111111111111
10000000000000000000000000E000000001
11C0000100000C0000000000000000000001
100000000000000000000000000000000001
100000000000000000000000000000000001
100000000000000000000000000000000001
111111111111111111111111111111111111
111111111111111111111111111111111111