111111111111
100P00000001
1000C000E001
100000000001
100000000001
111111111111