1111111111111111111111111111
111E100000000000000000000001
101P101111111111111111111101
101C100000000000000000001101
1110011111111111111111101101
1111000000000000000000001101
1000111111111111111111111101
1000000000000000000000000001
1C00111111111111111111111111
1111111111111111111111111111