11111111111111
11100000000001
11E10000000001
10000000000001
1P000000000001
11C00000000E01
11111111111111
11111111111111